NO ./xpm/diamond.xpm
SO ./xpm/basalt.xpm
WE ./xpm/cracked_wall.xpm
EA ./xpm/furnace_front_on.xpm
F 50,0,255
C 173,216,230


1111111111111111111111111
1000000000110000000000001
1011000001110000000000001
10010000000000000000000111111111
111111111011000001110000000000001
100000000011000001110111111111111
11110000000000000000000010001
11110000000000000001010010001
110000000000W0000000000010001
10000000000000000000000010001
10000000000000000001010010001
110000011101010111110111100111
11110111 1110101 101111010101
11111111 1111111 111111111111
