1111111111111111111
1CCCCCCCCCCCCCCCCC1
1CCCCCCCCCCCCCCCCC1
1PCCCCCCCCCCCCCCCE1
1111111111111111111