1111111111111
1000000000001
1P11111111111



1ZZZZZZZZZZZ1
1E11111111111
1111111111111